---
--- Generated by EmmyLua(https://github.com/EmmyLua)
--- Created by wbn.
--- DateTime: 2020/9/27 16:49
---

require("Framework.System")
require("Framework.SystemL")
require("Common.Main")
require("Framework.AsyncTask")
require("Runtime.Global.TaskScene")
require("Runtime.Global.TaskUI")
require("Config.Protocol.protoid")
require("Config.Configs")

---@class pb pb
---@field encode fun(ProtoID:string, request:table)
---@field decode fun(ProtoID:string, response:table)
pb = require("pb")
conv = require("conv")
F = require("Common.F")
BehaviorTree = require("Common.behavior3.behavior_tree")
BehaviorNode = require("Common.behavior3.behavior_node")
BehaviorNode.process(require("Runtime.B3Node.Process"))
protoc = require("Common.protoc")
serpent = require("Common.serpent")
rapidJson = require("rapidjson")
xluaUtil = require("Common.xlua.util")
Executors = require("Framework.Executors")---@type BIFramework.Execution.Executors
EventDispatcher = require("Common.EventDispatcher")()--事件派发器
LuaCSharpArr = require("Framework.LuaAccess.LuaCSharpArr")
AccessCore = require("Framework.LuaAccess.AccessCore")
require("Framework.LuaAccess.AccessInterface")
NetWork = CS.PitayaNetWork.Instance ---@type PitayaNetWork
-----------Unity API-----------------------------
Application = CS.UnityEngine.Application ---@type UnityEngine.Application
Resources = CS.UnityEngine.Resources ---@type UnityEngine.Resources
UnityWebRequest = CS.UnityEngine.Networking.UnityWebRequest ---@type UnityEngine.Networking.UnityWebRequest
UploadHandlerRaw = CS.UnityEngine.Networking.UploadHandlerRaw ---@type UnityEngine.Networking.UploadHandlerRaw
DownloadHandlerBuffer = CS.UnityEngine.Networking.DownloadHandlerBuffer ---@type UnityEngine.Networking.DownloadHandlerBuffer
Input = CS.UnityEngine.Input ---@type UnityEngine.Input
Camera = CS.UnityEngine.Camera ---@type UnityEngine.Camera
KeyCode = CS.UnityEngine.KeyCode ---@type UnityEngine.KeyCode
Screen = CS.UnityEngine.Screen ---@type UnityEngine.Screen
Physics = CS.UnityEngine.Physics ---@type UnityEngine.Physics
Image = CS.UnityEngine.UI.Image ---@type UnityEngine.UI.Image
Text = CS.UnityEngine.UI.Text ---@type UnityEngine.UI.Text
LuaListAdapter = CS.LuaListAdapter ---@type LuaListAdapter
LuaGridAdapter = CS.LuaGridAdapter ---@type LuaGridAdapter
LuaItemViewsHolder = CS.LuaItemViewsHolder ---@type LuaItemViewsHolder
TextMeshPro = CS.TMPro.TextMeshPro ---@type TMPro.TextMeshPro
TextMeshProUGUI = CS.TMPro.TextMeshProUGUI ---@type TMPro.TextMeshProUGUI
TMP_SpriteAsset = CS.TMPro.TMP_SpriteAsset ---@type TMPro.TMP_SpriteAsset
TMP_InputField = CS.TMPro.TMP_InputField ---@type TMPro.TMP_InputField
TMP_Dropdown = CS.TMPro.TMP_Dropdown ---@type TMPro.TMP_Dropdown
OptionData = CS.TMPro.TMP_Dropdown.OptionData ---@type TMPro.TMP_Dropdown.OptionData
InputField = CS.UnityEngine.UI.InputField ---@type UnityEngine.UI.InputField
Toggle = CS.UnityEngine.UI.Toggle ---@type UnityEngine.UI.Toggle
ToggleGroup = CS.UnityEngine.UI.ToggleGroup  ---@type UnityEngine.UI.ToggleGroup
RawImage = CS.UnityEngine.UI.RawImage ---@type UnityEngine.UI.RawImage
CanvasGroup = CS.UnityEngine.CanvasGroup ---@type UnityEngine.CanvasGroup
Canvas = CS.UnityEngine.Canvas ---@type UnityEngine.Canvas
Button = CS.UnityEngine.UI.Button ---@type UnityEngine.UI.Button
Scrollbar = CS.UnityEngine.UI.Scrollbar ---@type UnityEngine.UI.Scrollbar
ScrollRect = CS.UnityEngine.UI.ScrollRect ---@type UnityEngine.UI.ScrollRect
Plane = CS.UnityEngine.Plane ---@type UnityEngine.Plane
Touch = CS.UnityEngine.Touch ---@type UnityEngine.Touch
TouchPhase = CS.UnityEngine.TouchPhase ---@type UnityEngine.TouchPhase
Time = CS.UnityEngine.Time ---@type UnityEngine.Time
RectTransform = CS.UnityEngine.RectTransform ---@type UnityEngine.RectTransform
EventSystem = CS.UnityEngine.EventSystems.EventSystem ---@type UnityEngine.EventSystems.EventSystem
GrayscaleGroup = CS.BIFramework.GrayscaleGroup ---@type BIFramework.GrayscaleGroup
Random = CS.UnityEngine.Random ---@type UnityEngine.Random
SkinnedMeshRenderer = CS.UnityEngine.SkinnedMeshRenderer ---@type UnityEngine.SkinnedMeshRenderer
math.randomseed(os.time())
math.random()
Random.Range = LuaRandom
Rigidbody = CS.UnityEngine.Rigidbody ---@type UnityEngine.Rigidbody
RigidbodyConstraints = CS.UnityEngine.RigidbodyConstraints ---@type UnityEngine.RigidbodyConstraints
CharacterController = CS.UnityEngine.CharacterController ---@type UnityEngine.CharacterController
Collision = CS.UnityEngine.Collision ---@type UnityEngine.Collision
LayerMask = CS.UnityEngine.LayerMask ---@type UnityEngine.LayerMask
Animator = CS.UnityEngine.Animator ---@type UnityEngine.Animator
RenderTexture = CS.UnityEngine.RenderTexture ---@type UnityEngine.RenderTexture
Texture2D = CS.UnityEngine.Texture2D ---@type UnityEngine.Texture2D
Vector2Int = CS.UnityEngine.Vector2Int ---@type UnityEngine.Vector2Int
Vector3Int = CS.UnityEngine.Vector3Int ---@type UnityEngine.Vector3Int
Rect = CS.UnityEngine.Rect ---@type UnityEngine.Rect
DeviceIOS = CS.UnityEngine.iOS.Device ---@type UnityEngine.iOS.Device
SystemInfo = CS.UnityEngine.SystemInfo  ---@type UnityEngine.SystemInfo
SpriteRenderer = CS.UnityEngine.SpriteRenderer ---@type UnityEngine.SpriteRenderer
LayoutElement = CS.UnityEngine.UI.LayoutElement ---@type UnityEngine.UI.LayoutElement
SceneManager = CS.UnityEngine.SceneManagement.SceneManager ---@type UnityEngine.SceneManagement.SceneManager
LoadSceneMode = CS.UnityEngine.SceneManagement.LoadSceneMode ---@type UnityEngine.SceneManagement.LoadSceneMode
--------------Coroutine--------------------------
WaitForSeconds = CS.UnityEngine.WaitForSeconds ---@type UnityEngine.WaitForSeconds
WaitForEndOfFrame = CS.UnityEngine.WaitForEndOfFrame ---@type UnityEngine.WaitForEndOfFrame
WaitForFixedUpdate = CS.UnityEngine.WaitForFixedUpdate ---@type UnityEngine.WaitForFixedUpdate
WaitForSecondsRealtime = CS.UnityEngine.WaitForSecondsRealtime ---@type UnityEngine.WaitForSecondsRealtime
WaitUntil = CS.UnityEngine.WaitUntil ---@type UnityEngine.WaitUntil
WaitWhile = CS.UnityEngine.WaitWhile ---@type UnityEngine.WaitWhile
UniTask = CS.Cysharp.Threading.Tasks.UniTask ---@type Cysharp.Threading.Tasks.UniTask
LuaTable = CS.XLua.LuaTable ---@type Cysharp.Threading.Tasks.UniTask
UniTaskCompletionSource = CS.Cysharp.Threading.Tasks.UniTaskCompletionSource ---@type Cysharp.Threading.Tasks.UniTaskCompletionSource
PlayerLoopTiming = CS.Cysharp.Threading.Tasks.PlayerLoopTiming ---@type Cysharp.Threading.Tasks.PlayerLoopTiming
-----------Rendering-----------------------------
Universal = CS.UnityEngine.Rendering.Universal ---@type UnityEngine.Rendering.Universal
MeshRenderer = CS.UnityEngine.MeshRenderer ---@type UnityEngine.MeshRenderer
MaterialPropertyBlock = CS.UnityEngine.MaterialPropertyBlock ---@type UnityEngine.MaterialPropertyBlock
Volume = CS.UnityEngine.Rendering.Volume ---@type UnityEngine.Rendering.Volume
VolumeProfile = CS.UnityEngine.Rendering.VolumeProfile ---@type UnityEngine.Rendering.VolumeProfile
Bloom = CS.UnityEngine.Rendering.Universal.Bloom ---@type UnityEngine.Rendering.Universal.Bloom
ChannelMixer = CS.UnityEngine.Rendering.Universal.ChannelMixer ---@type UnityEngine.Rendering.Universal.ChannelMixer
ChromaticAberration = CS.UnityEngine.Rendering.Universal.ChromaticAberration ---@type UnityEngine.Rendering.Universal.ChromaticAberration
ColorAdjustments = CS.UnityEngine.Rendering.Universal.ColorAdjustments ---@type UnityEngine.Rendering.Universal.ColorAdjustments
ColorCurves = CS.UnityEngine.Rendering.Universal.ColorCurves ---@type UnityEngine.Rendering.Universal.ColorCurves
DepthOfField = CS.UnityEngine.Rendering.Universal.DepthOfField ---@type UnityEngine.Rendering.Universal.DepthOfField
FilmGrain = CS.UnityEngine.Rendering.Universal.FilmGrain ---@type UnityEngine.Rendering.Universal.FilmGrain
LensDistortion = CS.UnityEngine.Rendering.Universal.LensDistortion ---@type UnityEngine.Rendering.Universal.LensDistortion
LiftGammaGain = CS.UnityEngine.Rendering.Universal.LiftGammaGain ---@type UnityEngine.Rendering.Universal.LiftGammaGain
MotionBlur = CS.UnityEngine.Rendering.Universal.MotionBlur ---@type UnityEngine.Rendering.Universal.MotionBlur
PaniniProjection = CS.UnityEngine.Rendering.Universal.PaniniProjection ---@type UnityEngine.Rendering.Universal.PaniniProjection
Graphics = CS.UnityEngine.Graphics ---@type UnityEngine.Graphics
-----------Unity TYPE-----------------------------
GameObject = CS.UnityEngine.GameObject ---@type UnityEngine.GameObject
TextAsset = CS.UnityEngine.TextAsset ---@type UnityEngine.TextAsset
Sprite = CS.UnityEngine.Sprite ---@type UnityEngine.Sprite
Texture = CS.UnityEngine.Texture ---@type UnityEngine.Texture
AudioClip = CS.UnityEngine.AudioClip ---@type UnityEngine.AudioClip
SpriteAtlas = CS.UnityEngine.U2D.SpriteAtlas ---@type UnityEngine.U2D.SpriteAtlas
-----------System API----------------------------- 
List = CS.System.Collections.Generic.List ---@type System.Collections.Generic.List
Dictionary = CS.System.Collections.Generic.Dictionary ---@type System.Collections.Generic.Dictionary
DateTime = CS.System.DateTime ---@type System.DateTime
TimeSpan = CS.System.TimeSpan ---@type System.TimeSpan
File = CS.System.IO.File ---@type System.IO.File
Directory = CS.System.IO.Directory ---@type System.IO.Directory
GC = CS.System.GC ---@type System.GC
Encoding = CS.System.Text.Encoding ---@type System.Text.Encoding
Path = CS.System.IO.Path ---@type System.IO.Path
-----------Other API-----------------------------
DOTween = CS.DG.Tweening.DOTween---@type DG.Tweening.DOTween
Ease = CS.DG.Tweening.Ease ---@type DG.Tweening.Ease
RotateMode = CS.DG.Tweening.RotateMode ---@type DG.Tweening.RotateMode
LoopType = CS.DG.Tweening.LoopType ---@type DG.Tweening.LoopType
AxisConstraint = CS.DG.Tweening.AxisConstraint ---@type DG.Tweening.AxisConstraint
UnityBridge = CS.BIFramework.LuaUnityBridge ---@type BIFramework.LuaUnityBridge
Addressable = CS.BIFramework.LuaAddressable ---@type BIFramework.LuaAddressable
IResourceLocation = CS.UnityEngine.ResourceManagement.ResourceLocations.IResourceLocation
EventTriggerListener = CS.EventTriggerListener ---@type EventTriggerListener
LuaBehaviour = CS.BIFramework.Views.LuaBehaviour ---@type BIFramework.Views.LuaBehaviour
LuaEnvironment = CS.BIFramework.LuaEnvironment ---@type BIFramework.LuaEnvironment
Animancer = CS.Animancer ---@type Animancer
AnimancerEvent = CS.Animancer.AnimancerEvent ---@type Animancer.AnimancerEvent
NamedAnimancerComponent = CS.Animancer.NamedAnimancerComponent ---@type Animancer.NamedAnimancerComponent
CinemachineImpulseSource = CS.Cinemachine.CinemachineImpulseSource ---@type Cinemachine.CinemachineImpulseSource
Util = CS.Util ---@type Util
AsyncOperationStatus = CS.UnityEngine.ResourceManagement.AsyncOperations.AsyncOperationStatus ---@type UnityEngine.ResourceManagement.AsyncOperations.AsyncOperationStatus

---
--region -----------------------Logic-------------------------
require("Runtime.Global.Global")
require("Runtime.Global.UIPanel")
--endregion -----------------------Logic-------------------------

---@class GlobalSO
---@field frameRate GlobalSO.FrameRate 帧率限制
---@field onPlayModeChange function
---@field inputMode GlobalSO.InputMode 操作模式
---@field defaultScene string 默认场景名
---@field isShowLogo boolean 是否需要显示logo动画
---@field isOnline boolean 是否进行在线游戏
---@field isLoginSdk boolean 是否登录SDK
---@field isNeedUIOnLogin boolean 登陆时是否需要UI
---@field defaultPlayerName string 默认玩家名字
GlobalSO = CS.GlobalSO.Instance

return Configs.Analysis()